MsSubClass: определяет тип жилища, включенного в продажу <br>

MSZoning: определяет общую классификацию зоны продажи <br>

LotFrontage: длина улицы в футах, соединенной с домом <br>

LotArea: размер лота в квадратных футах <br>

Street: тип подъездной дороги к собственности <br>

Alley: тип подъездной аллеи к объекту <br>

LotShape: общая форма собственности <br>

LandContour: плоскость ландшафта собственности <br>

Utilities: тип доступных коммунальных услуг <br>

LotConfig: конфигурация лота <br>

LandSlope: наклон поверхности <br>

Neighborhood: физические местоположения в пределах города Эймс <br>

Condition1: близость к различным условиям <br>

Condition2: близость к различным условиям (если присутствует более одного) <br>

BldgType: тип жилища <br>

HouseStyle: стиль жилища <br>

OverallQual: оценивает общий материал и отделку дома <br>

OverallCond: оценивает общее состояние дома <br>

YearBuilt: дата первоначального строительства <br>

YearRemodAdd: Дата реконструкции (такая же, как и дата постройки, если без реконструкции или дополнений) <br>

RoofStyle: тип крыши <br>

RoofMatl: материал крыши <br>

Exterior1st: наружное покрытие дома <br>

Exterior2nd: наружное покрытие дома (если больше одного материала) <br>

MasVnrType: тип облицовки кладки <br>

MasVnrArea: площадь облицовки каменной кладкой в квадратных футах <br>

ExterQual: оценивает качество материала экстерьера <br>

ExterCond: оценивает текущее состояние материала снаружи <br>

Foundation: тип фундамента <br>

BsmtQual: оценивает высоту подвала <br>

BsmtCond: оценивает общее состояние подвала <br>

BsmtExposure: относится к стенам на уровне сада или пешеходного перехода <br>

BsmtFinType1: оценка готовой площади подвала <br>

BsmtFinSF1: готовые квадратные футы типа 1 <br>

BsmtFinType2: оценка готовой площади подвала (если несколько типов) <br>

BsmtFinSF2: готовые квадратные футы типа 2 <br>

BsmtUnfSF: незаконченные квадратные метры подвального помещения <br>

Heating: тип отопления <br>

HeatingQC: качество и состояние отопления <br>

CentralAir: центральное кондиционирование <br>

Electrical: электрическая система <br>

1stFlrSF: площадь 1 этажа <br>
 
2ndFlrSF: площадь 2 этажа  <br>

LowQualFinSF: некачественная отделка квадратных футов (все этажи) <br>

GrLivArea: надземная жилая площадь <br>

BsmtFullBath: полные ванные комнаты на цокольном этаже <br>

BsmtHalfBath: неполные ванные комнаты на цокольном этаже <br>

FullBath: полные ванные комнаты выше уровня земли <br>

HalfBath: неполные ванные комнаты выше уровня земли <br>

Bedroom: cпальни выше уровня земли (НЕ включают спальни на цокольном этаже) <br>

Kitchen: кухни <br>

KitchenQual: качество кухонь <br>

TotRmsAbvGrd: всего комнат выше уровня земли (не включая ванные комнаты) <br>

Functional: домашняя функциональность (предположим, что типовая, если вычеты не требуются) <br>

Fireplaces: количество каминов <br>

FireplaceQu: качество каминов <br>

GarageType: расположение гаража <br>

GarageYrBlt: год постройки гаража <br>
		
GarageFinish: внутренняя отделка гаража <br>

GarageCars: размер гаража по вместимости машин <br>

GarageArea: площадь гаража <br>

GarageQual: качество гаража <br>

GarageCond: состояние гаража <br>

PavedDrive: подъездная дорога <br>

WoodDeckSF: площадь деревянного настила <br>

OpenPorchSF: площадь открытой веранды <br>

EnclosedPorch: площадь закрытой веранды <br>

3SsnPorch: площадь многосезонной веранды <br>

ScreenPorch: площадь веранды экрана <br>

PoolArea: площадь бассейна <br>

PoolQC: качество бассейна <br>

Fence: качество забора <br>

MiscFeature: прочие функции, не включенные в другие категории <br>

MiscVal: стоимость дополнительных функций в долларах <br>

DateSold: дата продажи <br>

SaleType: тип продажи <br>

SaleCondition: условие продажи <br>

SalePrice: цена продажи